 char[,] map = {
                { '#','#','#','#','#','#','#','#','#','#','#','#','#','#','#','#','#','#','#','#','#','#','#','#','#'},
                { '#',' ',' ',' ',' ',' ',' ',' ',' ',' ',' ',' ','#',' ',' ',' ',' ',' ',' ',' ',' ',' ',' ',' ','#'},
                { '#',' ','#','#','#',' ','#','#','#','#','#',' ','#',' ','#','#','#','#','#',' ','#','#','#',' ','#'},
                { '#',' ','#','#','#',' ','#','#','#','#','#',' ','#',' ','#','#','#','#','#',' ','#','#','#',' ','#'},
                { '#',' ','#','#','#',' ','#','#','#','#','#',' ','#',' ','#','#','#','#','#',' ','#','#','#',' ','#'},
                { '#',' ',' ',' ',' ',' ',' ',' ',' ',' ',' ',' ',' ',' ',' ',' ',' ',' ',' ',' ',' ',' ',' ',' ','#'},
                { '#',' ','#','#','#',' ','#',' ','#','#','#','#','#','#','#','#','#',' ','#',' ','#','#','#',' ','#'},
                { '#',' ',' ',' ',' ',' ','#',' ',' ',' ',' ',' ','#',' ',' ',' ',' ',' ','#',' ',' ',' ',' ',' ','#'},
                { '#','#','#','#','#',' ','#','#','#','#','#',' ','#',' ','#','#','#','#','#',' ','#','#','#','#','#'},
                { '#','#','#','#','#',' ','#',' ',' ',' ',' ',' ',' ',' ',' ',' ',' ',' ','#',' ','#','#','#','#','#'},
                { '#','#','#','#','#',' ','#',' ','#',' ',' ',' ',' ',' ',' ',' ','#',' ','#',' ','#','#','#','#','#'},
                { '#',' ',' ',' ',' ',' ',' ',' ','#',' ',' ',' ','☻',' ',' ',' ','#',' ',' ',' ',' ',' ',' ',' ','#'},
                { '#','#','#','#','#',' ','#',' ','#','#','#','#','#','#','#','#','#',' ','#',' ','#','#','#','#','#'},
                { '#','#','#','#','#',' ','#',' ',' ',' ',' ',' ',' ',' ',' ',' ',' ',' ','#',' ','#','#','#','#','#'},
                { '#','#','#','#','#',' ','#',' ','#','#','#','#','#','#','#','#','#',' ','#',' ','#','#','#','#','#'},
                { '#',' ',' ',' ',' ',' ',' ',' ',' ',' ',' ',' ','#',' ',' ',' ',' ',' ',' ',' ',' ',' ',' ',' ','#'},
                { '#',' ','#','#','#',' ','#','#','#','#','#',' ','#',' ','#','#','#','#','#',' ','#','#','#',' ','#'},
                { '#',' ',' ',' ','#',' ',' ',' ',' ',' ',' ',' ','☺',' ',' ',' ',' ',' ',' ',' ','#',' ',' ',' ','#'},
                { '#','#','#',' ','#',' ','#',' ','#','#','#','#','#','#','#','#','#',' ','#',' ','#',' ','#','#','#'},
                { '#',' ',' ',' ',' ',' ','#',' ',' ',' ',' ',' ','#',' ',' ',' ',' ',' ','#',' ',' ',' ',' ',' ','#'},
                { '#',' ','#','#','#','#','#','#','#','#','#',' ','#',' ','#','#','#','#','#','#','#','#','#',' ','#'},
                { '#',' ',' ',' ',' ',' ',' ',' ',' ',' ',' ',' ',' ',' ',' ',' ',' ',' ',' ',' ',' ',' ',' ',' ','#'},
                { '#','#','#','#','#','#','#','#','#','#','#','#','#','#','#','#','#','#','#','#','#','#','#','#','#'}
               };